NO textures/north.xpm
SO textures/south.xpm
WE textures/west.xpm
EA textures/east.xpm
DO textures/brick_wall.xpm

C 000,000,255
F 0,255,0

111111111111111111111
101000001000000000001
101010101011111110001
100010100010000010001
111110101111101011101
100000101000101000001
101111101011101111111
101000001010100000101
101011111010111110101
101010001010100010101
101110101010101010101 111111
100000000000000000001 110001
100000011111000000001 111111
10000001   1000000001
10000001   1000000001
10000001   1000000001
10000001   1000000001
100000011111000000001
100000000000000000001
100000000000000000001
100000000000000000001
100000000000000000001
100000011100000000001
100000100010001111111
100001000001001000001
100000000000001000001
100000022000000111111
100000000000000000001
100300000000000000001
100000000000000000001
100000000000000000001
100000101010001010001
100000101010001010001
100000101010001010001
100000101010001010001
100000101010001010001
100000101010001010001
100000101010001010001
100000101010001010001
100000101010001010001
100000101010001010001
111111101011111011101
100000101000100010001
101000001000000000001
101110101110101110111
101000100000100010101
101011111111111010101
100010000000000010001
1S1010111011111111101
111111111111111111111
